69619296659291979367679793986762919395946992916392669597939394959597
67699161976997999794949598946369969995969196929865979399969592686499
96639769986794949366689669699395999197986699959296649294629391959665
92626394666769939599966599979597949496659693946664686169699663989292
65956395636198939198949591656793969696699565959963639895949196989169
64686396929899996791939497979199959196979494666962919568679191986594
93619668996493639391929896999997649296926269689462916192626265969791
93G92999597956893636766966262956168989493989794969599949893919868932
6768699869616891666898919196699664679294926695999197699898M926763921
94969191619498946399939197959767986495999391996563659895959465996493
91966499629869976795956398919492619861669591979295656497639899999562
67916291669199696267676199929296689664916493916963669165626494639694
95929599939596969494619295969564956263669798999966659492639793996598
62996793949595669698939594929369979794619191966264679699626391939666
91696369989165949597656894969968996562636267989692979798916198686395
94966499689498989962956864929399696892996394959364926965996697956498
97979367996797959694956361986898689166996699636962649664939164986764
93689662649564946198986194969391989893929495929795986194636391919294
93949999939665689794629492959499666296999893999292926867699694986396
66939962649799936191956161939393986298979399999591919192939898976364
91686395999398999168616562939798959566939392619962966366619899999798
95666695966593689692629195929966689795959698966662919891969599949499
91639597919496626867999394986663956799969397979595929894619163969492
93919464916994916264679969649796639792949992976461949865996398679198
96996594979691689291989296956791959968996399959194646461979592959698
97999267946495999593679497949492929769949966969167999968939395989991
99916798929997639762979791959896646798646297919368986396649469969365
97956397969398659399639494656698699161959463919462929169989699919665
63639964966661989767616992649166699997919561649562629499666995919797
91929592959867956999929999986669649897916895639263989297949798919269
61956194999291649463999891926493639394959197659764646967699199999191
61689699936194949691659563699762666567956895969395689296976893686591
96626592636199929998999598986861929869646661949392619292636894949466
66939661969961669197656894979163679698689192919463916996999165999691
