M1111111111111111111
12222222222222222221
12333333333333333321
12344444444444444321
12345555555555554321
12345666666666654321
12345677777777654321
12345678888887654321
12345678999987654321
1234567899G987654321
12345678999987654321
12345678999987654321
12345678888887654321
12345677777777654321
12345666666666654321
12345555555555554321
12344444444444444321
12333333333333333321
12222222222222222221
11111111111111111111