M9999999999999999999
19111111111111111111
19199999999999999991
19191111111111111191
19191999999999999191
19191911111111119191
19191919999999919191
19191919111111919191
19191919199991919191
1919191919G191919191
19191919199191919191
19191919111191919191
19191919999991919191
19191911111111919191
19191999999999919191
19191111111111119191
19199999999999999191
19111111111111111191
19999999999999999991
11111111111111111111